5 7
#######
#     #
#  #  #
#     #
#######
